212
2
date -9999
head -9999
19970820 -217
19970914 -212
19970928 -215
19971013 -210
19971028 -211
19971115 -210
19971127 -210
19971214 -206
19971228 -203
19980113 -200
19980129 -200
19980216 -208
19980302 -210
19980315 -203
19980329 -204
19980414 -210
19980428 -202
19980514 -207
19980529 -207
19980614 -204
19980628 -202
19980714 -205
19980729 -208
19980815 -212
19980828 -211
19980915 -200
19980928 -203
19981015 -204
19981028 -195
19981115 -195
19981129 -198
19981216 -198
19981229 -196
19990116 -196
19990130 -198
19990216 -199
19990302 -195
19990330 -201
19990416 -201
19990430 -205
19990530 -210
19990616 -211
19990728 -220
19990816 -215
19990830 -213
19990916 -214
19990926 -213
19991012 -208
19991030 -210
19991130 -204
19991216 -198
19991228 -194
20000114 -199
20000128 -201
20000215 -200
20000227 -198
20000314 -197
20000315 -197
20000331 -200
20000415 -204
20000430 -209
20000517 -211
20000530 -207
20000616 -212
20000716 -206
20000730 -208
20000814 -212
20000831 -212
20000916 -210
20000930 -210
20001015 -206
20001031 -201
20001130 -200
20001216 -197
20001230 -200
20010116 -200
20010130 -197
20010216 -200
20010228 -200
20010316 -200
20010330 -200
20010416 -202
20010430 -206
20010515 -208
20010527 -210
20010716 -215
20010730 -219
20010916 -203
20010930 -198
20011014 -201
20011030 -207
20011116 -205
20011229 -197
20020116 -195
20020130 -195
20020216 -198
20020302 -199
20020316 -203
20020331 -204
20020413 -210
20020430 -210
20020616 -211
20020630 -214
20020815 -213
20020927 -210
20021016 -208
20021030 -200
20021116 -201
20021130 -203
20021216 -201
20021229 -200
20030116 -201
20030131 -200
20030216 -204
20030302 -205
20030316 -209
20030330 -210
20030331 -200
20030413 -210
20030501 -212
20030516 -209
20030531 -213
20030614 -215
20030630 -214
20030716 -221
20030804 -227
20030816 -228
20030830 -227
20030914 -224
20030928 -220
20031012 -215
20031030 -211
20031116 -214
20031201 -211
20031216 -209
20031231 -205
20040116 -201
20040131 -199
20040214 -200
20040301 -202
20040314 -204
20040331 -205
20040416 -208
20040430 -213
20040517 -218
20040531 -219
20040614 -222
20040630 -221
20040716 -218
20040731 -220
20040817 -214
20040831 -210
20040916 -211
20040930 -210
20041015 -208
20041031 -210
20041114 -210
20041126 -204
20041217 -204
20050114 -206
20050128 -203
20050213 -198
20050227 -200
20050313 -202
20050330 -205
20050415 -206
20050516 -210
20050529 -212
20050612 -212
20050630 -212
20050715 -211
20050731 -206
20050816 -216
20050828 -206
20050916 -209
20050930 -210
20051014 -211
20051028 -211
20051116 -210
20051130 -205
20051216 -205
20051230 -209
20060116 -206
20060131 -210
20060216 -205
20060228 -206
20060312 -206
20060416 -209
20060430 -214
20060516 -218
20060531 -213
20060616 -216
20060630 -220
20060716 -228
20060727 -229
20060815 -216
20060831 -210
20060916 -210
20060930 -210
20061016 -211
20061031 -210
20061116 -205
20061130 -205
20061216 -203
20061230 -205
20070114 -209
20070126 -201
20070216 -203
20070227 -201
20070316 -202
20070330 -204
20071218 -208
