52
2
date -9999
head -9999
19990215 -359
19990315 -397
19990406 -400
19990414 -397
19990428 -405
19990517 -407
19990527 -409
19990613 -409
19990628 -409
19990828 -397
19991028 -410
19991115 -409
20001026 -414
20001117 -397
20001129 -399
20001218 -397
20010102 -397
20010115 -403
20010219 -398
20010302 -399
20010409 -403
20010417 -405
20010427 -403
20010518 -405
20010601 -409
20010614 -413
20010718 -411
20010730 -417
20010816 -411
20010828 -412
20010928 -392
20011101 -409
20011114 -405
20011130 -399
20020128 -400
20020218 -397
20020228 -389
20020328 -402
20020418 -408
20020501 -407
20020530 -415
20020611 -413
20020717 -413
20020801 -415
20020814 -417
20020927 -412
20021114 -399
20021202 -401
20030115 -397
20030319 -410
20030401 -413
20030804 -427
