212
2
date -9999
head -9999
19970820 -216
19970914 -213
19970928 -215
19971013 -210
19971028 -210
19971115 -209
19971127 -209
19971214 -206
19971228 -204
19980113 -199
19980129 -201
19980216 -207
19980302 -210
19980315 -204
19980329 -203
19980414 -210
19980428 -203
19980514 -206
19980529 -207
19980614 -202
19980628 -201
19980714 -204
19980729 -208
19980815 -211
19980828 -210
19980915 -200
19980928 -202
19981015 -201
19981028 -194
19981115 -194
19981129 -196
19981216 -197
19981229 -195
19990116 -196
19990130 -198
19990216 -198
19990302 -195
19990330 -200
19990416 -199
19990430 -205
19990530 -208
19990616 -211
19990728 -218
19990816 -214
19990830 -213
19990916 -214
19990926 -212
19991012 -208
19991030 -209
19991130 -203
19991216 -199
19991228 -194
20000114 -198
20000128 -201
20000215 -198
20000227 -196
20000314 -194
20000315 -194
20000331 -199
20000415 -204
20000430 -208
20000517 -212
20000530 -206
20000616 -211
20000716 -196
20000730 -208
20000814 -211
20000831 -213
20000916 -208
20000930 -209
20001015 -206
20001031 -201
20001130 -199
20001216 -198
20001230 -198
20010116 -200
20010130 -197
20010216 -201
20010228 -199
20010316 -199
20010330 -201
20010416 -200
20010430 -206
20010515 -206
20010527 -209
20010716 -215
20010730 -217
20010916 -201
20010930 -195
20011014 -200
20011030 -205
20011116 -205
20011229 -196
20020116 -196
20020130 -196
20020216 -197
20020302 -197
20020316 -202
20020331 -201
20020413 -208
20020430 -209
20020616 -212
20020630 -213
20020815 -212
20020927 -209
20021016 -207
20021030 -198
20021116 -200
20021130 -204
20021216 -201
20021229 -199
20030116 -201
20030131 -199
20030216 -203
20030302 -204
20030316 -209
20030330 -209
20030331 -199
20030413 -209
20030501 -214
20030516 -200
20030531 -211
20030614 -215
20030630 -216
20030716 -220
20030804 -226
20030816 -226
20030830 -226
20030914 -224
20030928 -220
20031012 -213
20031030 -210
20031116 -213
20031201 -210
20031216 -209
20031231 -204
20040116 -200
20040131 -199
20040214 -200
20040301 -201
20040314 -202
20040331 -205
20040416 -207
20040430 -211
20040517 -217
20040531 -219
20040614 -221
20040630 -218
20040716 -217
20040731 -217
20040817 -213
20040831 -209
20040916 -210
20040930 -209
20041015 -208
20041031 -210
20041114 -209
20041126 -204
20041217 -204
20050114 -204
20050128 -202
20050213 -197
20050227 -201
20050313 -201
20050330 -205
20050415 -206
20050516 -209
20050529 -212
20050612 -212
20050630 -211
20050715 -211
20050731 -206
20050816 -208
20050828 -206
20050916 -207
20050930 -209
20051014 -211
20051028 -210
20051116 -210
20051130 -203
20051216 -203
20051230 -204
20060116 -210
20060131 -209
20060216 -204
20060228 -205
20060312 -205
20060416 -208
20060430 -213
20060516 -216
20060531 -211
20060616 -215
20060630 -218
20060716 -227
20060727 -227
20060815 -216
20060831 -208
20060916 -209
20060930 -210
20061016 -210
20061031 -209
20061116 -205
20061130 -204
20061216 -201
20061230 -204
20070114 -201
20070126 -201
20070216 -202
20070227 -201
20070316 -204
20070330 -203
20071218 -207
